SO ./texture/xpm/backrooms/default/wall.xpm
NO ./texture/xpm/backrooms/default/ceiling.xpm
WE ./texture/xpm/backrooms/default/floor.xpm
EA ./texture/xpm/backrooms/default/wall.xpm

C 45,8,0
F 255,123,56


111111111
111010001
111010101
111000101
100000101
100000101
100000011
100000011
100000011
100000011
100000011
100000011
100000011
100000011
100000011
100000011
100000011
100000011
100000011
100000011
100000011
100000011
100000011
100000011
100000011
100000011
100000011
1000N0001
111111111