SO ./texture/xpm/backrooms/default/wall.xpm
NO ./texture/xpm/backrooms/default/ceiling.xpm
WE ./texture/xpm/backrooms/default/floor.xpm
EA ./texture/xpm/backrooms/default/wall.xpm

C 45,8,0
F 255,123,56


111111111111111111111
111111111111000011111
111111111111000011111
111111111111000011111
110000000000000011111
110000000000000011111
110000000011111111111
110000000000001111111
1100000N0000001111111
110000000000000001111
110000000011100001111
110000000011100001111
111111111111111111111
111111111111111111111