SO ./texture/xpm/backrooms/default/wall.xpm
NO ./texture/xpm/backrooms/default/ceiling.xpm
WE ./texture/xpm/backrooms/default/floor.xpm
EA ./texture/xpm/backrooms/default/wall.xpm

C 45,8,0
F 255,123,56


11111111111111111111
10000000000000000001
10000000000000000001
10000000000000000001
10000000000000000001
10000000000000000001
100000000000000000S1
11111111111111111111