SO ./texture/xpm/backrooms/default/wall.xpm
NO ./texture/xpm/backrooms/default/ceiling.xpm
WE ./texture/xpm/backrooms/default/floor.xpm
EA ./texture/xpm/backrooms/default/wall.xpm

C 255,255,0
F 255,0,0

        1
11111111111111111111
10000000000000000001
10000000000000000001
1000000000000000001
100000000S000000001
1000000000000000001
10000000000000000001
11111111111111111111