





EA      ./ruta_a_la_textura_EA.xpm


F 0, 155,          148

WE       ./ruta_a_la_textura_WE.xpm

NO ./ruta_a_la_textura_NO.xpm
SO 					./ruta_a_la_textura_SO.xpm


C 120, 40, 140


        
1111111111111111111111111
1000000000000000000000001
1000000000000000000000001
1000000000000000000000001
1000000000000000000000001
1000000000000000000000001
1111111111111111111111111
1000000000000S00000000001
1111111111111111111111111