SO ./texture/BRICK_WALL.xpm
NO ./texture/PLANT_WALL.xpm
WE ./texture/STONE_WALL.xpm
EA ./texture/WOOD_WALL.xpm

C 45,8,0
F 255,123,56


1111111111
10000000S1
1000000001
1000000001
1000000001
1000110001
1000110001
1000000001
1000000001
1000000001
1111111111