





EA      ./ruta_a_la_textura_EA.xpm


F 0, 155,          148

WE       ./ruta_a_la_textura_WE.xpm

NO ./ruta_a_la_textura_NO.xpm
SO 					./ruta_a_la_textura_SO.xpm



C 120, 40, 140




NO ./ruta_a_la_textura_NO.xpm
SO 	./ruta_a_la_textura_SO.xpm



C 254, 123, 12

        
1111111111111111111111111
1000000000000000000000001
1000000000000000000000001
1000000000000000000000001
1000000000000000000000001
1000000000000000000000001
1111111111111111111111111
10000000000000000000000S1
1111111111111111111111111