SO ./texture/xpm/backrooms/default/wall.xpm
NO ./texture/xpm/backrooms/default/ceiling.xpm
WE ./texture/xpm/backrooms/default/floor.xpm
EA ./texture/xpm/backrooms/default/wall.xpm

C 45,8,0
F 255,123,56


111111111
100000001
100000001
100001111
100010001
100100001
101000001
110000001
100000001
100000001
1000N0001
111111111