SO ./texture/xpm/backrooms/default/wall.xpm
NO ./texture/xpm/backrooms/default/ceiling.xpm
WE ./texture/xpm/backrooms/default/floor.xpm
EA ./texture/xpm/backrooms/default/wall.xpm

C 235,234,211
F 191,186,58

        1
11111111111111111111
10000000000000000001
10000000000000000001
1000000000000000001
100000000S000000001
1000000000000000001
10000000000000000001
11111111111111111111