





			EA      ./ruta_a_la_textura_EA.xpm


F 123, 123, 12 

WE       ./ruta_a_la_textura_WE.xpm

NO ./ruta_a_la_textura_NO.xpm
SO 					./ruta_a_la_textura_SO.xpm



C 254, 123, 12








        1111111111111111111111111
        1000000000110000000000001
        0011000001110000000000001
        1001000000000000000000001
111111111011000001110000000000001
100000000011000001110111111111111
11110111111111011100000000001
11110111111111011101010010001
11000000110101011100000010001
10000000000S00001100010010001
10000000000000001101010010001
110000010101010111110111100111
10000111 1110101 101111010001
11111111 1111111 111111111111




