SO ./texture/xpm/backrooms/default/wall.xpm
NO ./texture/xpm/backrooms/default/ceiling.xpm
WE ./texture/xpm/backrooms/default/floor.xpm
EA ./texture/xpm/backrooms/default/wall.xpm

C 255, 185, 0 
F 205, 230, 255
        1111111111111111111111111
		1000000000110000000000001
        1011000001110000000000001
        1001000000000000000000001
111111111011000001110000000000001
100000000011000001110111000111111
11110111111111011100000010001
11110111111111011101010010001
11000000110101011100000010001
100000000000000000000000000W1
10000000000000001101010010001
11000001110101011111011110011
11110111111101011101111010001
11111111111111111111111111111